WWWWWWWWWWWWWWWWWWWW
W     W  K      W AW
W     WWWWWW    W  W
WWWW     E W       W
W                  W
WWWWWWWWWWWWWWWW   W 
LZ  C W  K   W     W 
W  W  WWW   WWWW   W     
L WW  W    E W     W
W            W     W     
W    WWWW    E     W 
W       W       WW W     
WP W    WWWW    W  W     
WS  WG  W       W          
WWWWWWWWWWWWWWWWWWWW