WWWWWWWWWWWWWWWWWWW
WL                W
W   C    WW     K W  
W   W E  WWWWWWWWWW  
W   W             W  
W   W        WWWWWW  
W       E         W  
W          W      W  
WL         W      W  
WWWWW     E       W  
W K            WWWW  
W   W      W      W  
WWWWW   E  W  L   W  
WDP        WL  K  W  
WWWWWWWWWWWWWWWWWWW